WWWWWWWWWWWWWWWWWWWWWWWWWWWWWWWWWWWWWWWWWWWWWWWWWW
W   P  WW               WWWWWWWWWWWWWWW          W
WWWWWW     WWWWWWWWWWWWWWWWWWW                   W
W                     WWWWWWWWWWWWWWWWWWWWWWAAAA W
W              AAAAAAAAAAAAA                     W
W      AAAAAAAAAAAAAAW                           W
W                                                W
W                            WWWWWW              W
W    WWWWWWWWWWWWWWW                            WW
W                                                W
W                                 WWWWWWWWWWWWWWWW
W        AAAAAAAAAAAAAAAA                      WWW
W        AAAAAAAAAAAAAAAA       WWWWWWWWWWWWWWWWWW
W                                                W
W        AAAAAAAAAAAAAAAA                        W
W                        WWWWWWWWWWWWWWWWWWWWW   W
W                              AAAAAAAAAA        W
W  WWWWWWWWWWWWWW                       WWWWWW   W
W               W                                W
W               W    AAAAAAAAA              WWWWWW
W            WWWWWWWWAAAAAAAAAWWWWWWWWWWWWWWWWWW W
W                WWWAAAWWWWWWW                   W
W       WWWWWWWWWWWWW                            W
W  AAAAAAAAAAAAAAAAAAAA             AAAAAAAAAAAAAW
W                                   AAAAAAAAAAAAAW
W             WWWWWWWWWWWWWWWWWWWWWWWW           W
W      WWWWWWAAAAAAAAAAAAAAAAAAAAAAAWWW          W
W      WWWWWAAAAWWWWWWWWWWWWWWWWWAAAAWWW         W
W      WWWAAAAAAW                WAAA            W
WWWWWWWWWWWWWWWWWWWWWWWWWWWWWWWWWWWWWWWWWWWWWWWWWW