WWWWWWWWWWWWWWWWWWWWWWWWWWWWWWWWWWWWWWWWWWWWWWWWWWWW
W   P                     AAAAAAAAAAAAAAAA         W
WWWWWWWWWWWWW            AAAAAAAAAAAAAAAA          W
W            WWWWWWWW    AAAAAAAAAAAAAAAA          W
W      AAAAAAAAAAAAAAW    AAAAAAAAAAAAAAAA         W
W      AAAAAAAAAAAAAAW                             W
W      AAAAAAAAAAAAAAW                             W
W                            WWWWWW                W
W                              WWWWWWWWWWWWWWWWWWWWW
W                                                  W
W                                   WWWWWWWWWWWWWWWW
W        AAAAAAAAAAAAAAAA        WWWWWWWWWWWWWWWWWWW
W        AAAAAAAAAAAAAAAA         WWWWWWWWWWWWWWWWWW
W        AAAAAAAAAAAAAAAA                          W
W        AAAAAAAAAAAAAAAA                          W
W                        WWWWWWWWWWWWWWWWWWWWW     W
W                              AAAAAAAAAA          W
W WWWWWWWWWWWWWWWWWWWWWWWWWWWWWWWWWWWWW WWWWWW     W
W               W                                  W
W               W                             WWWWWW
W            WWWWWWWWWWWWWWWWWWWWWWWWWWWWWWWWWWW   W
W                                                  W
W       WWWWWWWWWWWWW                              w
M  AAAAAAAAAAAAAAAAAAAA      M      AAAAAAAAAAAAAW
M                            M      AAAAAAAAAAAAAM
MMMMMMMMMMMMMMMMMMMMMMMMMMMMMMMMMMMMMMMMMMMMMMMMMM